GameTitle=火焰之纹章: 多拉基亚 776

ContinueGameMenuOption=继续游戏
NewGameMenuOption=开始新游戏

OK=确定
Cancel=取消
FPS=帧率
Offset=偏移
Vector=坐标

MenuOptionCancel=取消
MenuOptionAttack=攻击
MenuOptionItem=道具
MenuOptionRest=待机
MenuOptionTroop=部队
MenuOptionBrief=情报
MenuOptionOptions=选项
MenuOptionSave=保存
MenuOptionEndPhase=终了

PlayerTurn=我方行动
EnemyTurn=敌方行动
AllyTurn=友方行动

LabelAttack=攻击
LabelCritical=必杀
LabelHit=命中
LabelAvoid=回避
LabelRange=攻击范围
LabelAtkSpeed=攻速

LabelSTR=力量
LabelMAG=魔力
LabelSKL=技术
LabelSPD=速度
LabelLUK=运气
LabelDEF=防御
LabelBLD=体格
LabelArmy=部队
LabelLead=指挥
LabelReact=行动
LabelCarry=同行
LabelMove=移动
LabelTire=疲劳
LabelStat=状态